Rank	Title	Worldwide Lifetime Gross	Domestic Lifetime Gross	 Domestic % 	Foreign Lifetime Gross	 Foreign % 	Year
1	Avatar	2847246203	760507625	 0.27 	2086738578	 0.73 	2009
2	Avengers: Endgame	2797501328	858373000	 0.31 	1939128328	 0.69 	2019
3	Titanic	2201647264	659363944	 0.30 	1542283320	 0.70 	1997
4	Star Wars: Episode VII 0 The Force Awakens	2069521700	936662225	 0.45 	1132859475	 0.55 	2015
5	Avengers: Infinity War	2048359754	678815482	 0.33 	1369544272	 0.67 	2018
6	Spider0Man: No Way Home	1832170405	772170405	 0.42 	1060000000	 0.58 	2021
7	Jurassic World	1670516444	652385625	 0.39 	1018130819	 0.61 	2015
8	The Lion King	1662899439	543638043	 0.33 	1119261396	 0.67 	2019
9	The Avengers	1518815515	623357910	 0.41 	895457605	 0.59 	2012
10	Furious 7	1515341399	353007020	 0.23 	1162334379	 0.77 	2015
11	Frozen II	1450026933	477373578	 0.33 	972653355	 0.67 	2019
12	Avengers: Age of Ultron	1402809540	459005868	 0.33 	943803672	 0.67 	2015
13	Black Panther	1347597973	700426566	 0.52 	647171407	 0.48 	2018
14	Harry Potter and the Deathly Hallows: Part 2	1342321665	381409310	 0.28 	960912355	 0.72 	2011
15	Star Wars: Episode VIII 0 The Last Jedi	1332698830	620181382	 0.47 	712517448	 0.53 	2017
16	Jurassic World: Fallen Kingdom	1310466296	417719760	 0.32 	892746536	 0.68 	2018
17	Frozen	1281508100	400953009	 0.31 	880555091	 0.69 	2013
18	Beauty and the Beast	1273576220	504481165	 0.40 	769095055	 0.60 	2017
19	Incredibles 2	1243089244	608581744	 0.49 	634507500	 0.51 	2018
20	The Fate of the Furious	1236005118	226008385	 0.18 	1009996733	 0.82 	2017
21	Iron Man 3	1214811252	409013994	 0.34 	805797258	 0.66 	2013
22	Minions	1159444662	336045770	 0.29 	823398892	 0.71 	2015
23	Captain America: Civil War	1153337496	408084349	 0.35 	745253147	 0.65 	2016
24	Aquaman	1148485886	335061807	 0.29 	813424079	 0.71 	2018
25	The Lord of the Rings: The Return of the King	1146030912	377845905	 0.33 	768185007	 0.67 	2003
26	Spider0Man: Far from Home	1131927996	390532085	 0.35 	741395911	 0.65 	2019
27	Captain Marvel	1128462972	426829839	 0.38 	701633133	 0.62 	2019
28	Transformers: Dark of the Moon	1123794079	352390543	 0.31 	771403536	 0.69 	2011
29	Skyfall	1108569499	304360277	 0.27 	804209222	 0.73 	2012
30	Transformers: Age of Extinction	1104054072	245439076	 0.22 	858614996	 0.78 	2014
31	Jurassic Park	1099428303	404214720	 0.37 	695213583	 0.63 	1993
32	The Dark Knight Rises	1081142612	448139099	 0.41 	633003513	 0.59 	2012
33	Joker	1074419384	335451311	 0.31 	738968073	 0.69 	2019
34	Star Wars: Episode IX 0 The Rise of Skywalker	1074149279	515202542	 0.48 	558946737	 0.52 	2019
35	Toy Story 4	1073394593	434038008	 0.40 	639356585	 0.60 	2019
36	Toy Story 3	1066970811	415004880	 0.39 	651965931	 0.61 	2010
37	Pirates of the Caribbean: Dead Man's Chest	1066179747	423315812	 0.40 	642863935	 0.60 	2006
38	The Lion King	1063611805	422783777	 0.40 	640828028	 0.60 	1994
39	Rogue One: A Star Wars Story	1056057720	532177324	 0.50 	523880396	 0.50 	2016
40	Aladdin	1050693953	355559216	 0.34 	695134737	 0.66 	2019
41	Pirates of the Caribbean: On Stranger Tides	1045713802	241071802	 0.23 	804642000	 0.77 	2011
42	Despicable Me 3	1034800131	264624300	 0.26 	770175831	 0.74 	2017
43	Finding Dory	1028570942	486295561	 0.47 	542275381	 0.53 	2016
44	Star Wars: Episode I 0 The Phantom Menace	1027082707	474544677	 0.46 	552538030	 0.54 	1999
45	Alice in Wonderland	1025468216	334191110	 0.33 	691277106	 0.67 	2010
46	Zootopia	1024121104	341268248	 0.33 	682852856	 0.67 	2016
47	Harry Potter and the Sorcerer's Stone	1017713119	318886962	 0.31 	698826157	 0.69 	2001
48	The Hobbit: An Unexpected Journey	1017003568	303003568	 0.30 	714000000	 0.70 	2012
49	The Dark Knight	1005973645	534858444	 0.53 	471115201	 0.47 	2008
50	Harry Potter and the Deathly Hallows: Part 1	977043483	296347721	 0.30 	680695762	 0.70 	2010
51	Despicable Me 2	970766005	368065385	 0.38 	602700620	 0.62 	2013
52	The Jungle Book	966554929	364001123	 0.38 	602553806	 0.62 	2016
53	Jumanji: Welcome to the Jungle	962542945	404540171	 0.42 	558002774	 0.58 	2017
54	The Hobbit: The Battle of the Five Armies	962182865	255119788	 0.27 	707063077	 0.73 	2014
55	Pirates of the Caribbean: At World's End	960996492	309420425	 0.32 	651576067	 0.68 	2007
56	The Hobbit: The Desolation of Smaug	959007513	258366855	 0.27 	700640658	 0.73 	2013
57	The Lord of the Rings: The Two Towers	947495095	342551365	 0.36 	604943730	 0.64 	2002
58	Harry Potter and the Order of the Phoenix	942172396	292353413	 0.31 	649818983	 0.69 	2007
59	Finding Nemo	940352645	380843261	 0.41 	559509384	 0.59 	2003
60	Harry Potter and the Half0Blood Prince	934454096	302305431	 0.32 	632148665	 0.68 	2009
61	Shrek 2	928760770	441226247	 0.48 	487534523	 0.52 	2004
62	Bohemian Rhapsody	910809311	216668042	 0.24 	694141269	 0.76 	2018
63	The Battle at Lake Changjin	902540935	342411	 0.00 	902198524	 1.00 	2021
64	The Lord of the Rings: The Fellowship of the Ring	898094742	316115420	 0.35 	581979322	 0.65 	2001
65	Harry Potter and the Goblet of Fire	896678241	290417905	 0.32 	606260336	 0.68 	2005
66	Spider0Man 3	894983373	336530303	 0.38 	558453070	 0.62 	2007
67	Ice Age 3: Dawn of the Dinosaurs	886686817	196573705	 0.22 	690113112	 0.78 	2009
68	Spectre	880681519	200074609	 0.23 	680606910	 0.77 	2015
69	Spider0Man: Homecoming	880166924	334201140	 0.38 	545965784	 0.62 	2017
70	Harry Potter and the Chamber of Secrets	879602366	262450136	 0.30 	617152230	 0.70 	2002
71	Ice Age 4: Continental Drift	877244782	161321843	 0.18 	715922939	 0.82 	2012
72	The Secret Life of Pets	875458631	368384330	 0.42 	507074301	 0.58 	2016
73	Batman v Superman: Dawn of Justice	873637528	330360194	 0.38 	543277334	 0.62 	2016
74	Wolf Warrior 2	870325439	2721100	 0.00 	867604339	 1.00 	2017
75	Star Wars: Episode III 0 Revenge of the Sith	868390560	380270577	 0.44 	488119983	 0.56 	2005
76	The Hunger Games: Catching Fire	865011746	424668047	 0.49 	440343699	 0.51 	2013
77	Guardians of the Galaxy Vol 2	863756051	389813101	 0.45 	473942950	 0.55 	2017
78	Inside Out	858848019	356921711	 0.42 	501926308	 0.58 	2015
79	Venom	856085151	213515506	 0.25 	642569645	 0.75 	2018
80	Thor: Ragnarok	853983911	315058289	 0.37 	538925622	 0.63 	2017
81	Inception	836836967	292576195	 0.35 	544260772	 0.65 	2010
82	Transformers: Revenge of the Fallen	836303693	402111870	 0.48 	434191823	 0.52 	2009
83	The Twilight Saga: Breaking Dawn 0 Part 2	829747654	292324737	 0.35 	537422917	 0.65 	2012
84	Spider0Man	825025036	407022860	 0.49 	418002176	 0.51 	2002
85	Wonder Woman	822824522	412815408	 0.50 	410009114	 0.50 	2017
86	Hi Mom	822009764	0	0.00	822009764	 1.00 	2021
87	Independence Day	817400891	306169268	 0.37 	511231623	 0.63 	1996
88	Fantastic Beasts and Where to Find Them	814044001	234037575	 0.29 	580006426	 0.71 	2016
89	Shrek the Third	813367380	322719944	 0.40 	490647436	 0.60 	2007
90	Coco	807817888	210460015	 0.26 	597357873	 0.74 	2017
91	Jumanji: The Next Level	800059707	320314960	 0.40 	479744747	 0.60 	2019
92	Harry Potter and the Prisoner of Azkaban	797361618	249975996	 0.31 	547385622	 0.69 	2004
93	Pirates of the Caribbean: Dead Men Tell No Tales	794881442	172558876	 0.22 	622322566	 0.78 	2017
94	ET the Extra0Terrestrial	792910554	435110554	 0.55 	357800000	 0.45 	1982
95	Mission: Impossible 0 Fallout	791657398	220159104	 0.28 	571498294	 0.72 	2018
96	2012	791217826	166112167	 0.21 	625105659	 0.79 	2009
97	Indiana Jones and the Kingdom of the Crystal Skull	790653942	317101119	 0.40 	473552823	 0.60 	2008
98	Spider0Man 2	788976453	373585825	 0.47 	415390628	 0.53 	2004
99	Fast & Furious 6	788680968	238679850	 0.30 	550001118	 0.70 	2013
100	Deadpool 2	785896609	324591735	 0.41 	461304874	 0.59 	2018
101	Deadpool	782836791	363070709	 0.46 	419766082	 0.54 	2016
102	Star Wars: Episode IV 0 A New Hope	775398007	460998507	 0.59 	314399500	 0.41 	1977
103	No Time to Die	774153007	160891007	 0.21 	613262000	 0.79 	2021
104	Guardians of the Galaxy	773350147	333718600	 0.43 	439631547	 0.57 	2014
105	The Da Vinci Code	760006945	217536138	 0.29 	542470807	 0.71 	2006
106	Fast & Furious Presents: Hobbs & Shaw	759056935	173956935	 0.23 	585100000	 0.77 	2019
107	Maleficent	758411779	241410378	 0.32 	517001401	 0.68 	2014
108	The Amazing Spider0Man	757930663	262030663	 0.35 	495900000	 0.65 	2012
109	The Hunger Games: Mockingjay 0 Part 1	755356711	337135885	 0.45 	418220826	 0.55 	2014
110	Shrek Forever After	752600867	238736787	 0.32 	513864080	 0.68 	2010
111	Madagascar 3: Europe's Most Wanted	746921274	216391482	 0.29 	530529792	 0.71 	2012
112	Suicide Squad	746846894	325100054	 0.44 	421746840	 0.56 	2016
113	X0Men: Days of Future Past	746045700	233921534	 0.31 	512124166	 0.69 	2014
114	The Chronicles of Narnia: The Lion the Witch and the Wardrobe	745013115	291710957	 0.39 	453302158	 0.61 	2005
115	Monsters University	743559645	268492764	 0.36 	475066881	 0.64 	2013
116	The Matrix Reloaded	741847937	281576461	 0.38 	460271476	 0.62 	2003
117	Up	735099102	293004164	 0.40 	442094938	 0.60 	2009
118	Ne Zha	726264074	3695533	 0.01 	722568541	 0.99 	2019
119	F9: The Fast Saga	726229501	173005945	 0.24 	553223556	 0.76 	2021
120	Gravity	723192705	274092705	 0.38 	449100000	 0.62 	2013
121	Captain America: The Winter Soldier	714421503	259766572	 0.36 	454654931	 0.64 	2014
122	The Twilight Saga: Breaking Dawn 0 Part 1	712205856	281287133	 0.39 	430918723	 0.61 	2011
123	The Twilight Saga: New Moon	711025481	297816253	 0.42 	413209228	 0.58 	2009
124	Dawn of the Planet of the Apes	710644566	208545589	 0.29 	502098977	 0.71 	2014
125	Transformers	709709780	319246193	 0.45 	390463587	 0.55 	2007
126	The Amazing Spider0Man 2	708982323	202853933	 0.29 	506128390	 0.71 	2014
127	It	701796444	328828874	 0.47 	372967570	 0.53 	2017
128	Interstellar	701729206	188020017	 0.27 	513709189	 0.73 	2014
129	The Wandering Earth	699992512	5971413	 0.01 	694021099	 0.99 	2019
130	The Twilight Saga: Eclipse	698491347	300531751	 0.43 	397959596	 0.57 	2010
131	Mission: Impossible 0 Ghost Protocol	694713380	209397903	 0.30 	485315477	 0.70 	2011
132	The Hunger Games	694394724	408010692	 0.59 	286384032	 0.41 	2012
133	Detective Chinatown 3	686257563	0	0.00	686257563	 1.00 	2021
134	Mission: Impossible 0 Rogue Nation	682716636	195042377	 0.29 	487674259	 0.71 	2015
135	Forrest Gump	678226133	330455270	 0.49 	347770863	 0.51 	1994
136	Doctor Strange	677796076	232641920	 0.34 	445154156	 0.66 	2016
137	The Sixth Sense	672806432	293506292	 0.44 	379300140	 0.56 	1999
138	Man of Steel	668045518	291045518	 0.44 	377000000	 0.56 	2013
139	Ice Age 2: The Meltdown	667094506	195330621	 0.29 	471763885	 0.71 	2006
140	Kung Fu Panda 2	665692281	165249063	 0.25 	500443218	 0.75 	2011
141	The Hunger Games: Mockingjay 0 Part 2	658344137	281723902	 0.43 	376620235	 0.57 	2015
142	Justice League	657926987	229024295	 0.35 	428902692	 0.65 	2017
143	Big Hero 6	657869686	222527828	 0.34 	435341858	 0.66 	2014
144	Fantastic Beasts: The Crimes of Grindelwald	654855901	159555901	 0.24 	495300000	 0.76 	2018
145	Pirates of the Caribbean: The Curse of the Black Pearl	654264015	305413918	 0.47 	348850097	 0.53 	2003
146	Star Wars: Episode II 0 Attack of the Clones	653779970	310676740	 0.48 	343103230	 0.52 	2002
147	Thor: The Dark World	644783140	206362140	 0.32 	438421000	 0.68 	2013
148	Moana	644136488	248757044	 0.39 	395379444	 0.61 	2016
149	Sing	634208384	270448425	 0.43 	363759959	 0.57 	2016
150	Kung Fu Panda	631746197	215434591	 0.34 	416311606	 0.66 	2008
151	The Incredibles	631607053	261441092	 0.41 	370165961	 0.59 	2004
152	The Martian	630162448	228433663	 0.36 	401728785	 0.64 	2015
153	Hancock	629443428	227946274	 0.36 	401497154	 0.64 	2008
154	Fast Five	626137675	209837675	 0.34 	416300000	 0.66 	2011
155	Men in Black 3	624026776	179020854	 0.29 	445005922	 0.71 	2012
156	Iron Man 2	623933331	312433331	 0.50 	311500000	 0.50 	2010
157	Ratatouille	623726085	206445654	 0.33 	417280431	 0.67 	2007
158	Ant0Man and the Wasp	622674139	216648740	 0.35 	406025399	 0.65 	2018
159	How to Train Your Dragon 2	621537519	177002924	 0.28 	444534595	 0.72 	2014
160	Logan	619179950	226277068	 0.37 	392902882	 0.63 	2017
161	The Lost World: Jurassic Park	618638999	229086679	 0.37 	389552320	 0.63 	1997
162	Casino Royale	616502912	167445960	 0.27 	449056952	 0.73 	2006
163	The Passion of the Christ	612054506	370782930	 0.61 	241271576	 0.39 	2004
164	Mamma Mia!	611257819	144169664	 0.24 	467088155	 0.76 	2008
165	Life of Pi	609016565	124987023	 0.21 	484029542	 0.79 	2012
166	Transformers: The Last Knight	605425157	130168683	 0.22 	475256474	 0.78 	2017
167	Madagascar: Escape 2 Africa	603900354	180010950	 0.30 	423889404	 0.70 	2008
168	War of the Worlds	603873119	234280354	 0.39 	369592765	 0.61 	2005
169	Tangled	592462816	200821936	 0.34 	391640880	 0.66 	2010
170	Quantum of Solace	589580482	168368427	 0.29 	421212055	 0.71 	2008
171	Men in Black	589390539	250690539	 0.43 	338700000	 0.57 	1997
172	The Croods	587235983	187168425	 0.32 	400067558	 0.68 	2013
173	The Hangover Part II	586764305	254464305	 0.43 	332300000	 0.57 	2011
174	Iron Man	585796247	319034126	 0.54 	266762121	 0.46 	2008
175	I Am Legend	585410052	256393010	 0.44 	329017042	 0.56 	2007
176	Ready Player One	582893671	137690172	 0.24 	445203499	 0.76 	2018
177	Monsters Inc	579707738	290642256	 0.50 	289065482	 0.50 	2001
178	Operation Red Sea	579330426	1543547	 0.00 	577786879	 1.00 	2018
179	Night at the Museum	574481229	250863268	 0.44 	323617961	 0.56 	2006
180	Fifty Shades of Grey	569651467	166167230	 0.29 	403484237	 0.71 	2015
181	Kong: Skull Island	566652812	168052812	 0.30 	398600000	 0.70 	2017
182	The Smurfs	563749323	142614158	 0.25 	421135165	 0.75 	2011
183	Cars 2	559852396	191452396	 0.34 	368400000	 0.66 	2011
184	King Kong	556906378	218080025	 0.39 	338826353	 0.61 	2005
185	Puss in Boots	554987477	149260504	 0.27 	405726973	 0.73 	2011
186	The Mermaid	553810228	3232685	 0.01 	550577543	 0.99 	2016
187	Armageddon	553709788	201578182	 0.36 	352131606	 0.64 	1998
188	The Day After Tomorrow	552639571	186740799	 0.34 	365898772	 0.66 	2004
189	Ted	549368315	218815487	 0.40 	330552828	 0.60 	2012
190	American Sniper	547426372	350126372	 0.64 	197300000	 0.36 	2014
191	Mission: Impossible II	546388108	215409889	 0.39 	330978219	 0.61 	2000
192	Detective Chinatown 2	544185156	1983984	 0.00 	542201172	 1.00 	2018
193	X0Men: Apocalypse	543934105	155442489	 0.29 	388491616	 0.71 	2016
194	Sherlock Holmes: A Game of Shadows	543848418	186848418	 0.34 	357000000	 0.66 	2011
195	Despicable Me	543113985	251513985	 0.46 	291600000	 0.54 	2010
196	Cinderella	542358331	201151353	 0.37 	341206978	 0.63 	2015
197	Madagascar	542063846	193595521	 0.36 	348468325	 0.64 	2005
198	World War Z	540455876	202807711	 0.38 	337648165	 0.62 	2013
199	Brave	538983207	237283207	 0.44 	301700000	 0.56 	2012
200	Star Wars: Episode V 0 The Empire Strikes Back	538375067	292753960	 0.54 	245621107	 0.46 	1980
201	The Simpsons Movie	536414293	183135014	 0.34 	353279279	 0.66 	2007
202	The Revenant	532950503	183637894	 0.34 	349312609	 0.66 	2015
203	The Meg	530438278	145443742	 0.27 	384994536	 0.73 	2018
204	Ralph Breaks the Internet	529323962	201091711	 0.38 	328232251	 0.62 	2018
205	Hotel Transylvania 3: Summer Vacation	528583774	167510016	 0.32 	361073758	 0.68 	2018
206	The Boss Baby	527965936	175003033	 0.33 	352962903	 0.67 	2017
207	Dunkirk	527016307	189740665	 0.36 	337275642	 0.64 	2017
208	Godzilla	524976069	200676069	 0.38 	324300000	 0.62 	2014
209	How to Train Your Dragon: The Hidden World	524389083	160799505	 0.31 	363589578	 0.69 	2019
210	Sherlock Holmes	524028679	209028679	 0.40 	315000000	 0.60 	2009
211	Meet the Fockers	522657936	279261160	 0.53 	243396776	 0.47 	2004
212	WALL·E	521311890	223808164	 0.43 	297503726	 0.57 	2008
213	Kung Fu Panda 3	521170825	143528619	 0.28 	377642206	 0.72 	2016
214	Terminator 2: Judgment Day	520881154	205881154	 0.40 	315000000	 0.60 	1991
215	Ant0Man	519311965	180202163	 0.35 	339109802	 0.65 	2015
216	The Grinch	512568819	271094731	 0.53 	241474088	 0.47 	2018
217	Ghost	505703557	217631306	 0.43 	288072251	 0.57 	1990
218	Aladdin	504050219	217350219	 0.43 	286700000	 0.57 	1992
219	Venom: Let There Be Carnage	502050366	213550366	 0.43 	288500000	 0.57 	2021
220	Rio 2	498781117	131538435	 0.26 	367242682	 0.74 	2014
221	Troy	497409852	133378256	 0.27 	364031596	 0.73 	2004
222	Toy Story 2	497375381	245852179	 0.49 	251523202	 0.51 	1999
223	How to Train Your Dragon	494879471	217581231	 0.44 	277298240	 0.56 	2010
224	Twister	494471524	241721524	 0.49 	252750000	 0.51 	1996
225	Oz the Great and Powerful	493311825	234911825	 0.48 	258400000	 0.52 	2013
226	Clash of the Titans	493214993	163214888	 0.33 	330000105	 0.67 	2010
227	Maleficent: Mistress of Evil	491730089	113929605	 0.23 	377800484	 0.77 	2019
228	War for the Planet of the Apes	490719763	146880162	 0.30 	343839601	 0.70 	2017
229	Shrek	487853320	267665011	 0.55 	220188309	 0.45 	2001
230	Mr & Mrs Smith	487287646	186336279	 0.38 	300951367	 0.62 	2005
231	Angels & Demons	485930816	133375846	 0.27 	352554970	 0.73 	2009
232	Teenage Mutant Ninja Turtles	485004754	191204754	 0.39 	293800000	 0.61 	2014
233	Bruce Almighty	484592874	242829261	 0.50 	241763613	 0.50 	2003
234	Rio	483866518	143619809	 0.30 	340246709	 0.70 	2011
235	Saving Private Ryan	482349603	217049603	 0.45 	265300000	 0.55 	1998
236	Rise of the Planet of the Apes	481800873	176760185	 0.37 	305040688	 0.63 	2011
237	Water Gate Bridge	480051716	0	0.00	480051716	 1.00 	2022
238	Home Alone	476684675	285761243	 0.60 	190923432	 0.40 	1990
239	Hotel Transylvania 2	475186706	169700110	 0.36 	305486596	 0.64 	2015
240	Star Wars: Episode VI 0 Return of the Jedi	475106177	309306177	 0.65 	165800000	 0.35 	1983
241	Charlie and the Chocolate Factory	474968763	206459076	 0.43 	268509687	 0.57 	2005
242	Indiana Jones and the Last Crusade	474171806	197171806	 0.42 	277000000	 0.58 	1989
243	San Andreas	474009154	155190832	 0.33 	318818322	 0.67 	2015
244	It Chapter Two	473093228	211593228	 0.45 	261500000	 0.55 	2019
245	Jaws	471411300	260758300	 0.55 	210653000	 0.45 	1975
246	Wreck0It Ralph	471222889	189422889	 0.40 	281800000	 0.60 	2012
247	The Hangover	469310836	277322503	 0.59 	191988333	 0.41 	2009
248	Godzilla vs Kong	468216094	100916094	 0.22 	367300000	 0.78 	2021
249	The Lego Movie	468060692	257760692	 0.55 	210300000	 0.45 	2014
250	Bumblebee	467989645	127195589	 0.27 	340794056	 0.73 	2018
251	Star Trek Into Darkness	467365246	228778661	 0.49 	238586585	 0.51 	2013
252	The Matrix	467222728	172076928	 0.37 	295145800	 0.63 	1999
253	Gladiator	465380802	187705427	 0.40 	277675375	 0.60 	2000
254	Pretty Woman	463406268	178406268	 0.38 	285000000	 0.62 	1990
255	Cars	461991867	244082982	 0.53 	217908885	 0.47 	2006
256	The Eight Hundred	461421559	372755	 0.00 	461048804	 1.00 	2020
257	X0Men: The Last Stand	460435291	234362462	 0.51 	226072829	 0.49 	2006
258	National Treasure: Book of Secrets	459242249	219964115	 0.48 	239278134	 0.52 	2007
259	Lucy	458863600	126663600	 0.28 	332200000	 0.72 	2014
260	Mission: Impossible	457696391	180981856	 0.40 	276714535	 0.60 	1996
261	300	456068181	210614939	 0.46 	245453242	 0.54 	2007
262	Demon Slayer: Mugen Train	454779627	49505008	 0.11 	405274619	 0.89 	2020
263	The Last Samurai	454627263	111127263	 0.24 	343500000	 0.76 	2003
264	Dying to Survive	451183391	6752	 0.00 	451176639	 1.00 	2018
265	Ocean's Eleven	450717150	183417150	 0.41 	267300000	 0.59 	2001
266	My People My Country	450064993	2356683	 0.01 	447708310	 0.99 	2019
267	Thor	449326618	181030624	 0.40 	268295994	 0.60 	2011
268	Pearl Harbor	449220945	198542554	 0.44 	250678391	 0.56 	2001
269	La La Land	448906865	151101803	 0.34 	297805062	 0.66 	2016
270	Tarzan	448191819	171091819	 0.38 	277100000	 0.62 	1999
271	Men in Black II	445135288	193735288	 0.44 	251400000	 0.56 	2002
272	The Bourne Ultimatum	444100035	227471070	 0.51 	216628965	 0.49 	2007
273	The Mummy Returns	443280904	202019785	 0.46 	241261119	 0.54 	2001
274	Alvin and the Chipmunks: The Squeakquel	443140005	219614612	 0.50 	223525393	 0.50 	2009
275	Les Misérables	442299309	148809770	 0.34 	293489539	 0.66 	2012
276	The Exorcist	441306145	232906145	 0.53 	208400000	 0.47 	1973
277	Mrs Doubtfire	441286195	219195243	 0.50 	222090952	 0.50 	1993
278	Terminator Genisys	440603537	89760956	 0.20 	350842581	 0.80 	2015
279	Warcraft	439048914	47365290	 0.11 	391683624	 0.89 	2016
280	The Greatest Showman	436949634	174340174	 0.40 	262609460	 0.60 	2017
281	A Star Is Born	436188866	215288866	 0.49 	220900000	 0.51 	2018
282	Pokémon Detective Pikachu	433514834	144105346	 0.33 	289409488	 0.67 	2019
283	Terminator 3: Rise of the Machines	433371112	150371112	 0.35 	283000000	 0.65 	2003
284	Shang0Chi and the Legend of the Ten Rings	432243292	224543292	 0.52 	207700000	 0.48 	2021
285	Die Another Day	431971116	160942139	 0.37 	271028977	 0.63 	2002
286	The Secret Life of Pets 2	430051293	158874395	 0.37 	271176898	 0.63 	2019
287	Cast Away	429632142	233632142	 0.54 	196000000	 0.46 	2000
288	Rampage	428028233	101028233	 0.24 	327000000	 0.76 	2018
289	The King's Speech	427374317	138797449	 0.32 	288576868	 0.68 	2010
290	The Matrix Revolutions	427344325	139313948	 0.33 	288030377	 0.67 	2003
291	The Intouchables	426588510	10198820	 0.02 	416389690	 0.98 	2011
292	Bad Boys for Life	426505244	206305244	 0.48 	220200000	 0.52 	2020
293	Django Unchained	426074373	162805434	 0.38 	263268939	 0.62 	2012
294	Beauty and the Beast	424967620	218967620	 0.52 	206000000	 0.48 	1991
295	Dances with Wolves	424208848	184208848	 0.43 	240000000	 0.57 	1990
296	My People My Homeland	422390820	0	0.00	422390820	 1.00 	2020
297	The Chronicles of Narnia: Prince Caspian	419665568	141621490	 0.34 	278044078	 0.66 	2008
298	Sex and the City	418765519	152647258	 0.36 	266118261	 0.64 	2008
299	The Captain	417282021	706572	 0.00 	416575449	 1.00 	2019
300	The Mummy	415933406	155385488	 0.37 	260547918	 0.63 	1999
301	The Chronicles of Narnia: The Voyage of the Dawn Treader	415686217	104386950	 0.25 	311299267	 0.75 	2010
302	Jason Bourne	415484914	162434410	 0.39 	253050504	 0.61 	2016
303	The Wolverine	414828246	132556852	 0.32 	282271394	 0.68 	2013
304	Kingsman: The Secret Service	414351546	128261724	 0.31 	286089822	 0.69 	2015
305	Night at the Museum: Battle of the Smithsonian	413106170	177243721	 0.43 	235862449	 0.57 	2009
306	Batman	411508343	251348343	 0.61 	160160000	 0.39 	1989
307	The Bodyguard	411006740	122006740	 0.30 	289000000	 0.70 	1992
308	Pacific Rim	411002906	101802906	 0.25 	309200000	 0.75 	2013
309	Kingsman: The Golden Circle	410902662	100234838	 0.24 	310667824	 0.76 	2017
310	The Mummy	409231607	80227895	 0.20 	329003712	 0.80 	2017
311	Ice Age 5: Collision Course	408754975	64063008	 0.16 	344691967	 0.84 	2016
312	Twilight	408430415	193962473	 0.47 	214467942	 0.53 	2008
313	Signs	408247917	227966634	 0.56 	180281283	 0.44 	2002
314	X2: X0Men United	407711549	214949694	 0.53 	192761855	 0.47 	2003
315	Alita: Battle Angel	404980543	85838210	 0.21 	319142333	 0.79 	2019
316	The Mummy: Tomb of the Dragon Emperor	403449830	102491776	 0.25 	300958054	 0.75 	2008
317	Prometheus	403354469	126477084	 0.31 	276877385	 0.69 	2012
318	Gone with the Wind	402352579	200852579	 0.50 	201500000	 0.50 	1939
319	Mamma Mia! Here We Go Again	402254384	120634935	 0.30 	281619449	 0.70 	2018
320	Eternals	402064899	164870234	 0.41 	237194665	 0.59 	2021
321	Dune	400375904	108031945	 0.27 	292343959	 0.73 	2021
322	TRON: Legacy	400063852	172062763	 0.43 	228001089	 0.57 	2010
323	Mission: Impossible III	398479497	134029801	 0.34 	264449696	 0.66 	2006
324	Snow White and the Huntsman	396592829	155332381	 0.39 	241260448	 0.61 	2012
325	Grease	396271103	190071103	 0.48 	206200000	 0.52 	1978
326	Toy Story	394436586	223225679	 0.57 	171210907	 0.43 	1995
327	Solo: A Star Wars Story	392924807	213767512	 0.54 	179157295	 0.46 	2018
328	The Wolf of Wall Street	392000694	116900694	 0.30 	275100000	 0.70 	2013
329	Superman Returns	391081192	200081192	 0.51 	191000000	 0.49 	2006
330	Robin Hood: Prince of Thieves	390493908	165493908	 0.42 	225000000	 0.58 	1991
331	Indiana Jones and the Raiders of the Lost Ark	389925971	248159971	 0.64 	141766000	 0.36 	1981
332	Independence Day: Resurgence	389681935	103144286	 0.26 	286537649	 0.74 	2016
333	Live Free or Die Hard	388156011	134529403	 0.35 	253626608	 0.65 	2007
334	Monster Hunt	387053506	32766	 0.00 	387020740	 1.00 	2015
335	Godzilla: King of the Monsters	386600138	110500138	 0.29 	276100000	 0.71 	2019
336	Home	386041607	177397510	 0.46 	208644097	 0.54 	2015
337	Star Trek	385680446	257730019	 0.67 	127950427	 0.33 	2009
338	1917	384919389	159227644	 0.41 	225691745	 0.59 	2019
339	Happy Feet	384336108	198000317	 0.52 	186335791	 0.48 	2006
340	Cars 3	383930656	152901115	 0.40 	231029541	 0.60 	2017
341	Ice Age	383257136	176387405	 0.46 	206869731	 0.54 	2002
342	Back to the Future	381906762	211406762	 0.55 	170500000	 0.45 	1985
343	Fifty Shades Darker	381545846	114581250	 0.30 	266964596	 0.70 	2017
344	Monsters vs Aliens	381509870	198351526	 0.52 	183158344	 0.48 	2009
345	Black Widow	379751655	183651655	 0.48 	196100000	 0.52 	2021
346	Godzilla	379014294	136314294	 0.36 	242700000	 0.64 	1998
347	True Lies	378882411	146282411	 0.39 	232600000	 0.61 	1994
348	Slumdog Millionaire	378410542	141319928	 0.37 	237090614	 0.63 	2008
349	Taken 2	376152455	139854287	 0.37 	236298168	 0.63 	2012
350	GI Joe: Retaliation	375740705	122523060	 0.33 	253217645	 0.67 	2013
351	Mad Max: Fury Road	375658750	154058340	 0.41 	221600410	 0.59 	2015
352	Spider0Man: Into the Spider0Verse	375540831	190241310	 0.51 	185299521	 0.49 	2018
353	Shark Tale	374583879	160861908	 0.43 	213721971	 0.57 	2004
354	Once Upon a Time In Hollywood	374565754	142502728	 0.38 	232063026	 0.62 	2019
355	What Women Want	374111707	182811707	 0.49 	191300000	 0.51 	2000
356	The Adventures of Tintin	373993951	77591831	 0.21 	296402120	 0.79 	2011
357	Batman Begins	373661946	206852432	 0.55 	166809514	 0.45 	2005
358	Penguins of Madagascar	373515621	83850911	 0.22 	289664710	 0.78 	2014
359	X0Men Origins: Wolverine	373062864	179883157	 0.48 	193179707	 0.52 	2009
360	The Golden Compass	372234864	70107728	 0.19 	302127136	 0.81 	2007
361	Fifty Shades Freed	371987838	100407760	 0.27 	271580078	 0.73 	2018
362	Hitch	371594210	179495555	 0.48 	192098655	 0.52 	2005
363	Terminator Salvation	371353001	125322469	 0.34 	246030532	 0.66 	2009
364	Captain America: The First Avenger	370569774	176654505	 0.48 	193915269	 0.52 	2011
365	Edge of Tomorrow	370541256	100206256	 0.27 	270335000	 0.73 	2014
366	There's Something About Mary	369884651	176484651	 0.48 	193400000	 0.52 	1998
367	Gone Girl	369330363	167767189	 0.45 	201563174	 0.55 	2014
368	The Fugitive	368875760	183875760	 0.50 	185000000	 0.50 	1993
369	Jurassic Park III	368780809	181171875	 0.49 	187608934	 0.51 	2001
370	My Big Fat Greek Wedding	368744044	241438208	 0.65 	127305836	 0.35 	2002
371	Hello Mr Billionaire	366961907	0	0.00	366961907	 1.00 	2018
372	Die Hard with a Vengeance	366101666	100012499	 0.27 	266089167	 0.73 	1995
373	Shazam!	365971656	140371656	 0.38 	225600000	 0.62 	2019
374	The Nun	365551694	117450119	 0.32 	248101575	 0.68 	2018
375	Alvin and the Chipmunks	365352546	217326974	 0.59 	148025572	 0.41 	2007
376	Notting Hill	363889678	116089678	 0.32 	247800000	 0.68 	1999
377	Tenet	363656624	58456624	 0.16 	305200000	 0.84 	2020
378	A Bug's Life	363258859	162798565	 0.45 	200460294	 0.55 	1998
379	Night at the Museum: Secret of the Tomb	363204635	113746621	 0.31 	249458014	 0.69 	2014
380	Ocean's Twelve	362744280	125544280	 0.35 	237200000	 0.65 	2004
381	Planet of the Apes	362211740	180011740	 0.50 	182200000	 0.50 	2001
382	The Hangover Part III	362000072	112200072	 0.31 	249800000	 0.69 	2013
383	The World Is Not Enough	361832400	126943684	 0.35 	234888716	 0.65 	1999
384	Monster Hunt 2	361682618	706153	 0.00 	360976465	 1.00 	2018
385	Fast & Furious	360366870	155064265	 0.43 	205302605	 0.57 	2009
386	Noah	359200044	101200044	 0.28 	258000000	 0.72 	2014
387	The Karate Kid	359126022	176591618	 0.49 	182534404	 0.51 	2010
388	Home Alone 2: Lost in New York	358994850	173585516	 0.48 	185409334	 0.52 	1992
389	Hotel Transylvania	358375603	148313048	 0.41 	210062555	 0.59 	2012
390	Minority Report	358372926	132072926	 0.37 	226300000	 0.63 	2002
391	Your Name	358180115	5017246	 0.01 	353162869	 0.99 	2016
392	Top Gun	357288178	180258178	 0.50 	177030000	 0.50 	1986
393	The Legend of Tarzan	356700357	126643061	 0.36 	230057296	 0.64 	2016
394	American Beauty	356296601	130096601	 0.37 	226200000	 0.63 	1999
395	Spirited Away	355697283	13750644	 0.04 	341946639	 0.96 	2001
396	Apollo 13	355237933	173837933	 0.49 	181400000	 0.51 	1995
397	Rain Man	354825435	172825435	 0.49 	182000000	 0.51 	1988
398	The Great Gatsby	353642274	144840419	 0.41 	208801855	 0.59 	2013
399	Dumbo	353284621	114766307	 0.32 	238518314	 0.68 	2019
400	I Robot	353133898	144801023	 0.41 	208332875	 0.59 	2004
401	Basic Instinct	352927224	117727224	 0.33 	235200000	 0.67 	1992
402	Murder on the Orient Express	352794081	102826543	 0.29 	249967538	 0.71 	2017
403	X0Men: First Class	352616690	146408305	 0.42 	206208385	 0.58 	2011
404	The Angry Birds Movie	352333929	107509366	 0.31 	244824563	 0.69 	2016
405	GoldenEye	352194034	106429941	 0.30 	245764093	 0.70 	1995
406	Catch Me If You Can	352114312	164615351	 0.47 	187498961	 0.53 	2002
407	Now You See Me	351723989	117723989	 0.33 	234000000	 0.67 	2013
408	Hannibal	351692268	165092268	 0.47 	186600000	 0.53 	2001
409	The Mask	351583407	119938730	 0.34 	231644677	 0.66 	1994
410	Peter Rabbit	351496066	115253424	 0.33 	236242642	 0.67 	2018
411	Speed	350448145	121248145	 0.35 	229200000	 0.65 	1994
412	Dinosaur	349822765	137748063	 0.39 	212074702	 0.61 	2000
413	Mary Poppins Returns	349546142	171958438	 0.49 	177587704	 0.51 	2018
414	Deep Impact	349464664	140464664	 0.40 	209000000	 0.60 	1998
415	The Lorax	348840316	214030500	 0.61 	134809816	 0.39 	2012
416	The Maze Runner	348319861	102427862	 0.29 	245891999	 0.71 	2014
417	The Smurfs 2	347545360	71017784	 0.20 	276527576	 0.80 	2013
418	National Treasure	347512318	173008894	 0.50 	174503424	 0.50 	2004
419	Rush Hour 2	347325802	226164286	 0.65 	121161516	 0.35 	2001
420	Trolls	346864886	153707064	 0.44 	193157822	 0.56 	2016
421	xXx: Return of Xander Cage	346118277	44898413	 0.13 	301219864	 0.87 	2017
422	Pocahontas	346079773	141579773	 0.41 	204500000	 0.59 	1995
423	How the Grinch Stole Christmas	345573032	260465005	 0.75 	85108027	 0.25 	2000
424	Star Trek Beyond	343471816	158848340	 0.46 	184623476	 0.54 	2016
425	Alvin and the Chipmunks: Chipwrecked	342695435	133110742	 0.39 	209584693	 0.61 	2011
426	Wanted	342463063	134508551	 0.39 	207954512	 0.61 	2008
427	The Flintstones	341631208	130531208	 0.38 	211100000	 0.62 	1994
428	A Quiet Place	340952971	188024361	 0.55 	152928610	 0.45 	2018
429	Enchanted	340487836	127807262	 0.38 	212680574	 0.62 	2007
430	Over the Hedge	339795890	155019340	 0.46 	184776550	 0.54 	2006
431	300: Rise of an Empire	337580051	106580051	 0.32 	231000000	 0.68 	2014
432	Batman Forever	336567158	184069126	 0.55 	152498032	 0.45 	1995
433	Prince of Persia: The Sands of Time	336365676	90759676	 0.27 	245606000	 0.73 	2009
434	The Curious Case of Benjamin Button	335802786	127509326	 0.38 	208293460	 0.62 	2008
435	Journey 2: The Mysterious Island	335260290	103860290	 0.31 	231400000	 0.69 	2012
436	The Rock	335062621	134069511	 0.40 	200993110	 0.60 	1996
437	The Great Wall	334933831	45540830	 0.14 	289393001	 0.86 	2016
438	Now You See Me 2	334897606	65075540	 0.19 	269822066	 0.81 	2016
439	Never Say Die	334530869	0	0.00	334530869	 1.00 	2017
440	Sing 2	333814755	148338755	 0.44 	185476000	 0.56 	2021
441	Fantastic Four	333535934	154696080	 0.46 	178839854	 0.54 	2005
442	Indiana Jones and the Temple of Doom	333107271	179870271	 0.54 	153237000	 0.46 	1984
443	Tomorrow Never Dies	333011068	125304276	 0.38 	207706792	 0.62 	1997
444	Back to the Future Part II	332500002	119000002	 0.36 	213500000	 0.64 	1989
445	The Good Dinosaur	332207671	123087120	 0.37 	209120551	 0.63 	2015
446	Free Guy	331526598	121626598	 0.37 	209900000	 0.63 	2021
447	22 Jump Street	331333876	191719337	 0.58 	139614539	 0.42 	2014
448	Meet the Parents	330444045	166244045	 0.50 	164200000	 0.50 	2000
449	Who Framed Roger Rabbit	329803958	156452370	 0.47 	173351588	 0.53 	1988
450	Black Swan	329398046	106954678	 0.32 	222443368	 0.68 	2010
451	The Perfect Storm	328718434	182618434	 0.56 	146100000	 0.44 	2000
452	Crocodile Dundee	328203506	174803506	 0.53 	153400000	 0.47 	1986
453	Crazy Alien	327598891	0	0.00	327598891	 1.00 	2019
454	Se7en	327333559	100125643	 0.31 	227207916	 0.69 	1995
455	John Wick: Chapter 3 0 Parabellum	327281779	171015687	 0.52 	156266092	 0.48 	2019
456	The Devil Wears Prada	326706115	124740460	 0.38 	201965655	 0.62 	2006
457	Taken 3	326479141	89256424	 0.27 	237222717	 0.73 	2015
458	The Hunchback of Notre Dame	325338851	100138851	 0.31 	225200000	 0.69 	1996
459	A Christmas Carol	325286646	137855863	 0.42 	187430783	 0.58 	2009
460	The SpongeBob Movie: Sponge Out of Water	325186032	162994032	 0.50 	162192000	 0.50 	2015
461	Schindler's List	322161245	96898818	 0.30 	225262427	 0.70 	1993
462	Megamind	321885765	148415853	 0.46 	173469912	 0.54 	2010
463	The Conjuring 2	321788219	102470008	 0.32 	219318211	 0.68 	2016
464	Green Book	321752656	85080171	 0.26 	236672485	 0.74 	2018
465	Lethal Weapon 3	321731527	144731527	 0.45 	177000000	 0.55 	1992
466	The Ugly Truth	321682600	88915214	 0.28 	232767386	 0.72 	2009
467	Robin Hood	321669741	105269730	 0.33 	216400011	 0.67 	2010
468	Inglourious Basterds	321457747	120540719	 0.37 	200917028	 0.63 	2009
469	101 Dalmatians	320689294	136189294	 0.42 	184500000	 0.58 	1996
470	The Conjuring	320360015	137400141	 0.43 	182959874	 0.57 	2013
471	Fatal Attraction	320145693	156645693	 0.49 	163500000	 0.51 	1987
472	Sonic the Hedgehog	319715683	148974665	 0.47 	170741018	 0.53 	2020
473	The Last Airbender	319713881	131772187	 0.41 	187941694	 0.59 	2010
474	The Proposal	317375031	163958031	 0.52 	153417000	 0.48 	2009
475	A Beautiful Mind	316791257	170742341	 0.54 	146048916	 0.46 	2001
476	Beverly Hills Cop	316360478	234760478	 0.74 	81600000	 0.26 	1984
477	Air Force One	315156409	172956409	 0.55 	142200000	 0.45 	1997
478	The Expendables 2	314975955	85028192	 0.27 	229947763	 0.73 	2012
479	Chicken Little	314432837	135386665	 0.43 	179046172	 0.57 	2005
480	The Polar Express	314215454	187935490	 0.60 	126279964	 0.40 	2004
481	As Good as It Gets	314178011	148478011	 0.47 	165700000	 0.53 	1997
482	Maze Runner: The Scorch Trials	312296056	81697192	 0.26 	230598864	 0.74 	2015
483	Resident Evil: The Final Chapter	312242626	26830068	 0.09 	285412558	 0.91 	2016
484	Austin Powers: The Spy Who Shagged Me	312016928	206040086	 0.66 	105976842	 0.34 	1999
485	The Lego Batman Movie	311950384	175750384	 0.56 	136200000	 0.44 	2017
486	Knives Out	311605581	165363234	 0.53 	146242347	 0.47 	2019
487	Ocean's Thirteen	311312624	117154724	 0.38 	194157900	 0.62 	2007
488	Little Fockers	310650585	148438600	 0.48 	162211985	 0.52 	2010
489	Bolt	309979994	114053579	 0.37 	195926415	 0.63 	2008
490	Ransom	309492681	136492681	 0.44 	173000000	 0.56 	1996
491	Runaway Bride	309460292	152257509	 0.49 	157202783	 0.51 	1999
492	The Blind Side	309208309	255959475	 0.83 	53248834	 0.17 	2009
493	The Ex0File 3: The Return of The Exes	307592427	838959	 0.00 	306753468	 1.00 	2017
494	The Fault in Our Stars	307166834	124872350	 0.41 	182294484	 0.59 	2014
495	The Pursuit of Happyness	307127625	163566459	 0.53 	143561166	 0.47 	2006
496	Rise of the Guardians	306941670	103412758	 0.34 	203528912	 0.66 	2012
497	Close Encounters of the Third Kind	306889114	135189114	 0.44 	171700000	 0.56 	1977
498	Chicago	306776732	170687518	 0.56 	136089214	 0.44 	2002
499	Annabelle: Creation	306515884	102092201	 0.33 	204423683	 0.67 	2017
500	Wonder	306209289	132422809	 0.43 	173786480	 0.57 	2017
501	Skyscraper	304868961	68420120	 0.22 	236448841	 0.78 	2018
502	A Good Day to Die Hard	304654182	67349198	 0.22 	237304984	 0.78 	2013
503	Mulan	304320254	120620254	 0.40 	183700000	 0.60 	1998
504	Dangal	303723636	12391761	 0.04 	291331875	 0.96 	2016
505	Passengers	303144152	100014699	 0.33 	203129453	 0.67 	2016
506	Battleship	303025485	65422625	 0.22 	237602860	 0.78 	2012
507	Liar Liar	302710615	181410615	 0.60 	121300000	 0.40 	1997
508	GI Joe: The Rise of Cobra	302469017	150201498	 0.50 	152267519	 0.50 	2009
509	Wrath of the Titans	301970083	83670083	 0.28 	218300000	 0.72 	2012
510	Fantastic 4: Rise of the Silver Surfer	301913131	131921738	 0.44 	169991393	 0.56 	2007
511	Hook	300854823	119654823	 0.40 	181200000	 0.60 	1991
512	Rocky IV	300473716	127873716	 0.43 	172600000	 0.57 	1985
513	Superman	300451603	134451603	 0.45 	166000000	 0.55 	1978
514	Rambo: First Blood Part II	300400432	150415432	 0.50 	149985000	 0.50 	1985
515	Resident Evil: Afterlife	300228084	60128566	 0.20 	240099518	 0.80 	2010
516	Van Helsing	300157638	120177084	 0.40 	179980554	 0.60 	2004
517	Stuart Little	300135367	140035367	 0.47 	160100000	 0.53 	1999
518	Beverly Hills Cop II	299965036	153665036	 0.51 	146300000	 0.49 	1987
519	Alice Through the Looking Glass	299820798	77041381	 0.26 	222779417	 0.74 	2016
520	My Best Friend's Wedding	299288605	127120029	 0.42 	172168576	 0.58 	1997
521	Real Steel	299268508	85468508	 0.29 	213800000	 0.71 	2011
522	Horton Hears a Who!	298572799	154529439	 0.52 	144043360	 0.48 	2008
523	Ocean's Eight	297718711	140218711	 0.47 	157500000	 0.53 	2018
524	A Quiet Place Part II	297372261	160072261	 0.54 	137300000	 0.46 	2021
525	The Divergent Series: Insurgent	297002527	130179072	 0.44 	166823455	 0.56 	2015
526	Look Who's Talking	296999813	140088813	 0.47 	156911000	 0.53 	1989
527	Austin Powers in Goldmember	296938801	213307889	 0.72 	83630912	 0.28 	2002
528	Ghostbusters	296578797	243578797	 0.82 	53000000	 0.18 	1984
529	Miss Peregrine's Home for Peculiar Children	296482446	87242834	 0.29 	209239612	 0.71 	2016
530	X0Men	296339528	157299718	 0.53 	139039810	 0.47 	2000
531	Ferdinand	296069199	84410380	 0.29 	211658819	 0.71 	2017
532	Shutter Island	294805697	128012934	 0.43 	166792763	 0.57 	2010
533	Doctor Dolittle	294456605	144156605	 0.49 	150300000	 0.51 	1998
534	Bee Movie	293514336	126631277	 0.43 	166883059	 0.57 	2007
535	Salt	293503354	118311368	 0.40 	175191986	 0.60 	2010
536	G0Force	292817898	119436770	 0.41 	173381128	 0.59 	2009
537	The Departed	291465373	132384315	 0.45 	159081058	 0.55 	2006
538	What Lies Beneath	291420351	155464351	 0.53 	135956000	 0.47 	2000
539	Pacific Rim: Uprising	290930148	59874525	 0.21 	231055623	 0.79 	2018
540	The Bourne Supremacy	290835269	176241941	 0.61 	114593328	 0.39 	2004
541	Sex and the City 2	290745055	95347692	 0.33 	195397363	 0.67 	2010
542	Shakespeare in Love	289317794	100317794	 0.35 	189000000	 0.65 	1998
543	Divergent	288885818	150947895	 0.52 	137937923	 0.48 	2014
544	Coming to America	288752301	128152301	 0.44 	160600000	 0.56 	1988
545	Wedding Crashers	288467645	209255921	 0.73 	79211724	 0.27 	2005
546	Bridesmaids	288383523	169106725	 0.59 	119276798	 0.41 	2011
547	Maze Runner: The Death Cure	288175335	58032443	 0.20 	230142892	 0.80 	2018
548	Casper	287928194	100328194	 0.35 	187600000	 0.65 	1995
549	American Pie 2	287553595	145103595	 0.50 	142450000	 0.50 	2001
550	Pitch Perfect 2	287144079	184296230	 0.64 	102847849	 0.36 	2015
551	The Green Mile	286801374	136801374	 0.48 	150000000	 0.52 	1999
552	Oblivion	286168572	89107235	 0.31 	197061337	 0.69 	2013
553	Elysium	286140700	93050117	 0.33 	193090583	 0.67 	2013
554	Lethal Weapon 4	285444603	130444603	 0.46 	155000000	 0.54 	1998
555	John Carter	284139100	73078100	 0.26 	211061000	 0.74 	2012
556	Turbo	282570682	83028128	 0.29 	199542554	 0.71 	2013
557	Paddington	282377683	76271832	 0.27 	206105851	 0.73 	2014
558	Bridget Jones's Diary	281995610	71543427	 0.25 	210452183	 0.75 	2001
559	The Tourist	278780441	67631157	 0.24 	211149284	 0.76 	2010
560	Split	278454417	138291365	 0.50 	140163052	 0.50 	2017
561	Scary Movie	278019771	157019771	 0.56 	121000000	 0.44 	2000
562	xXx	277448382	142109382	 0.51 	135339000	 0.49 	2002
563	The Bourne Legacy	276144750	113203870	 0.41 	162940880	 0.59 	2012
564	Mr Peabody & Sherman	275698039	111506430	 0.40 	164191609	 0.60 	2014
565	Scooby0Doo	275650703	153294164	 0.56 	122356539	 0.44 	2002
566	Lincoln	275293450	182207973	 0.66 	93085477	 0.34 	2012
567	Lara Croft: Tomb Raider	274703340	131168070	 0.48 	143535270	 0.52 	2001
568	Tomb Raider	274650803	58250803	 0.21 	216400000	 0.79 	2018
569	The Expendables	274470394	103068524	 0.38 	171401870	 0.62 	2010
570	Cloudy with a Chance of Meatballs 2	274325949	119793567	 0.44 	154532382	 0.56 	2013
571	The Nutty Professor	273961019	128814019	 0.47 	145147000	 0.53 	1996
572	Jerry Maguire	273552592	153952592	 0.56 	119600000	 0.44 	1996
573	Bad Boys II	273339556	138608444	 0.51 	134731112	 0.49 	2003
574	Lilo & Stitch	273144151	145794338	 0.53 	127349813	 0.47 	2002
575	The Silence of the Lambs	272742922	130742922	 0.48 	142000000	 0.52 	1991
576	Grown Ups	271457301	162001186	 0.60 	109456115	 0.40 	2010
577	Neighbors	270665134	150157400	 0.55 	120507734	 0.45 	2014
578	The Firm	270248367	158348367	 0.59 	111900000	 0.41 	1993
579	We're the Millers	269994119	150394119	 0.56 	119600000	 0.44 	2012
580	Gran Torino	269958228	148095302	 0.55 	121862926	 0.45 	2008
581	10000 BC	269784201	94784201	 0.35 	175000000	 0.65 	2008
582	American Gangster	269755430	130164645	 0.48 	139590785	 0.52 	2007
583	Epic	268426634	107518682	 0.40 	160907952	 0.60 	2013
584	Exodus: Gods and Kings	268175631	65014513	 0.24 	203161118	 0.76 	2014
585	Bambi	267447150	102247150	 0.38 	165200000	 0.62 	1942
586	The Princess and the Frog	267045765	104400899	 0.39 	162644866	 0.61 	2009
587	Batman Returns	266892996	162902340	 0.61 	103990656	 0.39 	1992
588	Indecent Proposal	266614059	106614059	 0.40 	160000000	 0.60 	1993
589	Something's Gotta Give	265328738	124728738	 0.47 	140600000	 0.53 	2003
590	Bridget Jones: The Edge of Reason	265126918	40226215	 0.15 	224900703	 0.85 	2004
591	The Incredible Hulk	264770996	134806913	 0.51 	129964083	 0.49 	2008
592	Waterworld	264218220	88246220	 0.33 	175972000	 0.67 	1995
593	The Truman Show	264118201	125618201	 0.48 	138500000	 0.52 	1998
594	Charlie's Angels	264105545	125305545	 0.47 	138800000	 0.53 	2000
595	The Fifth Element	263920180	63820180	 0.24 	200100000	 0.76 	1997
596	Parasite	263020130	53369749	 0.20 	209650381	 0.80 	2019
597	Jumanji	262821940	100499940	 0.38 	162322000	 0.62 	1995
598	Borat: Cultural Learnings of America for Make Benefit Glorious Nation of Kazakhstan	262552893	128505958	 0.49 	134046935	 0.51 	2006
599	Robots	262511490	128200012	 0.49 	134311478	 0.51 	2005
600	Knight and Day	261989769	76423035	 0.29 	185566734	 0.71 	2008
601	Total Recall	261317921	119412921	 0.46 	141905000	 0.54 	1990
602	This Is It	261183588	72091016	 0.28 	189092572	 0.72 	2009
603	Terminator: Dark Fate	261119292	62253077	 0.24 	198866215	 0.76 	2019
604	The Lone Ranger	260502115	89302115	 0.34 	171200000	 0.66 	2013
605	Super 8	260095986	127004179	 0.49 	133091807	 0.51 	2011
606	Mojin: The Lost Legend	259368448	1243810	 0.00 	258124638	 1.00 	2015
607	Blade Runner 2049	259334548	92054159	 0.35 	167280389	 0.65 	2017
608	Charlie's Angels: Full Throttle	259175788	100830111	 0.39 	158345677	 0.61 	2003
609	Rush Hour 3	258097122	140125968	 0.54 	117971154	 0.46 	2007
610	The Full Monty	257938649	45950122	 0.18 	211988527	 0.82 	1997
611	Kung Fu Yoga	257753889	362657	 0.00 	257391232	 1.00 	2017
612	Annabelle	257579282	84273813	 0.33 	173305469	 0.67 	2014
613	The Village	256697520	114197520	 0.44 	142500000	 0.56 	2003
614	Lost in Hong Kong	256283912	1302281	 0.01 	254981631	 0.99 	2015
615	Erin Brockovich	256271286	125595205	 0.49 	130676081	 0.51 	2000
616	Pegasus	255863112	0	0.00	255863112	 1.00 	2019
617	Marley & Me	255743093	143153751	 0.56 	112589342	 0.44 	2008
618	Halloween	255614941	159342015	 0.62 	96272926	 0.38 	2018
619	Get Out	255589157	176040665	 0.69 	79548492	 0.31 	2016
620	Us	255185482	175084580	 0.69 	80100902	 0.31 	2019
621	Cliffhanger	255000211	84049211	 0.33 	170951000	 0.67 	1993
622	Baahubali 2: The Conclusion	254158390	20186659	 0.08 	233971731	 0.92 	2017
623	Babe	254134910	63658910	 0.25 	190476000	 0.75 	1995
624	Men in Black: International	253890701	80001807	 0.32 	173888894	 0.68 	2019
625	Wild Hogs	253625427	168273550	 0.66 	85351877	 0.34 	2007
626	High School Musical 3: Senior Year	252909177	90559416	 0.36 	162349761	 0.64 	2008
627	Hercules	252712101	99112101	 0.39 	153600000	 0.61 	1997
628	X0Men: Dark Phoenix	252442974	65845974	 0.26 	186597000	 0.74 	2019
629	True Grit	252276927	171243005	 0.68 	81033922	 0.32 	2010
630	Bean	251212670	45319423	 0.18 	205893247	 0.82 	1997
631	American Hustle	251171807	150117807	 0.60 	101054000	 0.40 	2013
632	Enemy of the State	250849789	111549836	 0.44 	139299953	 0.56 	1998
633	You've Got Mail	250821495	115821495	 0.46 	135000000	 0.54 	1998
634	Eragon	250425512	75030163	 0.30 	175395349	 0.70 	2006
635	Brother Bear	250397798	85336277	 0.34 	165061521	 0.66 	2003
636	The Mask of Zorro	250288523	94095523	 0.38 	156193000	 0.62 	1998
637	The Ring	249348933	129128133	 0.52 	120220800	 0.48 	2002
638	The Blair Witch Project	248639099	140539099	 0.57 	108100000	 0.43 	1999
639	Unbreakable	248118121	95011339	 0.38 	153106782	 0.62 	2000
640	Journey to the West: The Demons Strike Back	247585244	880346	 0.00 	246704898	 1.00 	2017
641	Dumb and Dumber	247275374	127175374	 0.51 	120100000	 0.49 	1994
642	Glass	246999039	111048468	 0.45 	135950571	 0.55 	2019
643	Grown Ups 2	246984278	133668525	 0.54 	113315753	 0.46 	2013
644	The Peanuts Movie	246233113	130178411	 0.53 	116054702	 0.47 	2015
645	The Godfather	246120986	134966411	 0.55 	111154575	 0.45 	1972
646	Rango	245724603	123477607	 0.50 	122246996	 0.50 	2011
647	Four Weddings and a Funeral	245700832	52700832	 0.21 	193000000	 0.79 	1994
648	Face/Off	245676146	112276146	 0.46 	133400000	 0.54 	1997
649	Teenage Mutant Ninja Turtles: Out of the Shadows	245623848	82051601	 0.33 	163572247	 0.67 	2016
650	Dark Shadows	245527149	79727149	 0.32 	165800000	 0.68 	2012
651	Dolittle	245438444	77047065	 0.31 	168391379	 0.69 	2020
652	Hulk	245285165	132177234	 0.54 	113107931	 0.46 	2003
653	Love Actually	245203167	59696144	 0.24 	185507023	 0.76 	2003
654	The Bravest	245179562	290217	 0.00 	244889345	 1.00 	2019
655	Welcome to the Sticks	245144417	0	0.00	245144417	 1.00 	2008
656	Back to the Future Part III	245077583	88277583	 0.36 	156800000	 0.64 	1990
657	Pixels	244874809	78747585	 0.32 	166127224	 0.68 	2015
658	Hercules	244819862	72688614	 0.30 	172131248	 0.70 	2014
659	Rush Hour	244721064	141186864	 0.58 	103534200	 0.42 	1998
660	Journey to the Center of the Earth	244232688	101704370	 0.42 	142528318	 0.58 	2008
661	Encanto	243767032	95004134	 0.39 	148762898	 0.61 	2021
662	After Earth	243611982	60522097	 0.25 	183089885	 0.75 	2013
663	A Few Good Men	243240178	141340178	 0.58 	101900000	 0.42 	1992
664	Cloudy with a Chance of Meatballs	243006126	124870275	 0.51 	118135851	 0.49 	2009
665	8 Mile	242875078	116750901	 0.48 	126124177	 0.52 	2002
666	Daddy's Home	242786137	150357137	 0.62 	92429000	 0.38 	2015
667	RoboCop	242688965	58607007	 0.24 	184081958	 0.76 	2014
668	Eraser	242295562	101295562	 0.42 	141000000	 0.58 	1996
669	Alien: Covenant	240891763	74262031	 0.31 	166629732	 0.69 	2017
670	Sully	240797623	125070033	 0.52 	115727590	 0.48 	2016
671	Assassin's Creed	240697856	54647948	 0.23 	186049908	 0.77 	2016
672	Click	240685326	137355633	 0.57 	103329693	 0.43 	2006
673	Legend of Deification	240663149	214670	 0.00 	240448479	 1.00 	2020
674	Resident Evil: Retribution	240159255	42345531	 0.18 	197813724	 0.82 	2012
675	Die Hard 2	240031274	117540947	 0.49 	122490327	 0.51 	1990
676	Crocodile Dundee II	239606210	109306210	 0.46 	130300000	 0.54 	1988
677	Planes	239258712	90288712	 0.38 	148970000	 0.62 	2013
678	Crazy Rich Asians	238539198	174532921	 0.73 	64006277	 0.27 	2018
679	Batman & Robin	238235719	107353792	 0.45 	130881927	 0.55 	1997
680	Downton Abbey	237860050	96854135	 0.41 	141005915	 0.59 	2019
681	Gulliver's Travels	237382724	42779261	 0.18 	194603463	 0.82 	2010
682	Gone in 60 Seconds	237202299	101648571	 0.43 	135553728	 0.57 	2000
683	Saturday Night Fever	237113184	94213184	 0.40 	142900000	 0.60 	1977
684	Silver Linings Playbook	236412453	132092958	 0.56 	104319495	 0.44 	2012
685	2 Fast 2 Furious	236350661	127154901	 0.54 	109195760	 0.46 	2003
686	Howl's Moving Castle	236284206	5576743	 0.02 	230707463	 0.98 	2004
687	Hidden Figures	235956898	169607287	 0.72 	66349611	 0.28 	2016
688	AI Artificial Intelligence	235926552	78616689	 0.33 	157309863	 0.67 	2001
689	Dead Poets Society	235860116	95860116	 0.41 	140000000	 0.59 	1989
690	Spy	235666219	110825712	 0.47 	124840507	 0.53 	2015
691	American Pie	235483004	102561004	 0.44 	132922000	 0.56 	1999
692	American Reunion	234989584	57011521	 0.24 	177978063	 0.76 	2012
693	Big Daddy	234801895	163479795	 0.70 	71322100	 0.30 	1999
694	Alvin and the Chipmunks: The Road Chip	234798636	85886987	 0.37 	148911649	 0.63 	2015
695	The Imitation Game	233555708	91125683	 0.39 	142430025	 0.61 	2014
696	Cruella	233503234	86103234	 0.37 	147400000	 0.63 	2021
697	The Day the Earth Stood Still	233093859	79366978	 0.34 	153726881	 0.66 	2008
698	American Wedding	232722935	104565114	 0.45 	128157821	 0.55 	2003
699	The Girl with the Dragon Tattoo	232617430	102515793	 0.44 	130101637	 0.56 	2011
700	Juno	232372681	143495265	 0.62 	88877416	 0.38 	2007
701	Argo	232325503	136025503	 0.59 	96300000	 0.41 	2012
702	Mr Bean's Holiday	232225908	33302167	 0.14 	198923741	 0.86 	2007
703	The English Patient	231976425	78676425	 0.34 	153300000	 0.66 	1996
704	Sister Act	231605150	139605150	 0.60 	92000000	 0.40 	1992
705	Annabelle Comes Home	231252591	74152591	 0.32 	157100000	 0.68 	2019
706	Constantine	230884728	75976178	 0.33 	154908550	 0.67 	2005
707	Get Smart	230685453	130319208	 0.56 	100366245	 0.44 	2008
708	Space Jam	230418342	90418342	 0.39 	140000000	 0.61 	1996
709	Life Is Beautiful	230098753	57563264	 0.25 	172535489	 0.75 	1998
710	The Heat	229930771	159582188	 0.69 	70348583	 0.31 	1996
711	Ghostbusters	229147509	128350574	 0.56 	100796935	 0.44 	2016
712	Ghost Rider	228738393	115802596	 0.51 	112935797	 0.49 	2007
713	Goodbye Mr Loser	228122928	1293626	 0.01 	226829302	 0.99 	2015
714	Paddington 2	227978645	40891591	 0.18 	187087054	 0.82 	2017
715	Sleepless in Seattle	227927165	126808165	 0.56 	101119000	 0.44 	1993
716	Lethal Weapon 2	227853986	147253986	 0.65 	80600000	 0.35 	1989
717	The Green Hornet	227817248	98780042	 0.43 	129037206	 0.57 	2011
718	Out of Africa	227514205	87071205	 0.38 	140443000	 0.62 	1985
719	Youth	227091290	1891956	 0.01 	225199334	 0.99 	2017
720	Baby Driver	226945087	107825862	 0.48 	119119225	 0.52 	2017
721	Immortals	226904017	83504017	 0.37 	143400000	 0.63 	2011
722	Taken	226837760	145000989	 0.64 	81836771	 0.36 	2008
723	Percy Jackson & the Olympians: The Lightning Thief	226497209	88768303	 0.39 	137728906	 0.61 	2010
724	Hansel & Gretel: Witch Hunters	226349749	55703475	 0.25 	170646274	 0.75 	2013
725	Valerian and the City of a Thousand Planets	225973340	41189488	 0.18 	184783852	 0.82 	2017
726	Good Will Hunting	225933435	138433435	 0.61 	87500000	 0.39 	1997
727	Better Days	225918798	1921657	 0.01 	223997141	 0.99 	2019
728	Ford v Ferrari	225508210	117624357	 0.52 	107883853	 0.48 	2019
729	Jumper	225132113	80172128	 0.36 	144959985	 0.64 	2008
730	The Social Network	224920375	96962694	 0.43 	127957681	 0.57 	2010
731	Chicken Run	224834564	106834564	 0.48 	118000000	 0.52 	2000
732	Con Air	224012234	101117573	 0.45 	122894661	 0.55 	1997
733	Elf	223853736	176630408	 0.79 	47223328	 0.21 	2003
734	Interview with the Vampire: The Vampire Chronicles	223664608	105264608	 0.47 	118400000	 0.53 	1994
735	Flightplan	223387299	89707299	 0.40 	133680000	 0.60 	2005
736	Yes Man	223241637	97690976	 0.44 	125550661	 0.56 	2008
737	Non0Stop	222809600	92168600	 0.41 	130641000	 0.59 	2014
738	Honey I Shrunk the Kids	222724172	130724172	 0.59 	92000000	 0.41 	1989
739	Fahrenheit 9/11	222446882	119194771	 0.54 	103252111	 0.46 	2004
740	Wild Wild West	222104681	113804681	 0.51 	108300000	 0.49 	1999
741	My Country My Parents	221701823	166807	 0.00 	221535016	 1.00 	2021
742	Geostorm	221600160	33700160	 0.15 	187900000	 0.85 	2017
743	Presumed Innocent	221303188	86303188	 0.39 	135000000	 0.61 	1990
744	Jungle Cruise	220889446	116987516	 0.53 	103901930	 0.47 	2021
745	Scary Movie 3	220673217	110003217	 0.50 	110670000	 0.50 	2003
746	Collateral	220239925	101005703	 0.46 	119234222	 0.54 	2004
747	Inferno	220021259	34343574	 0.16 	185677685	 0.84 	2016
748	Knocked Up	219922417	148768917	 0.68 	71153500	 0.32 	2007
749	Green Lantern	219851172	116601172	 0.53 	103250000	 0.47 	2011
750	What Happens in Vegas	219375562	80277646	 0.37 	139097916	 0.63 	2008
751	It's Complicated	219103655	112735375	 0.51 	106368280	 0.49 	2009
752	The Terminal	219100084	77872883	 0.36 	141227201	 0.64 	2004
753	Captain Phillips	218791811	107100855	 0.49 	111690956	 0.51 	2013
754	The Prince of Egypt	218613188	101413188	 0.46 	117200000	 0.54 	1998
755	Jack Reacher	218340595	80070736	 0.37 	138269859	 0.63 	2012
756	Kingdom of Heaven	218122627	47398413	 0.22 	170724214	 0.78 	2005
757	The Emoji Movie	217776646	86089513	 0.40 	131687133	 0.60 	2017
758	Dracula Untold	217124280	56280355	 0.26 	160843925	 0.74 	2014
759	Too Cool to Kill	217106290	72432	 0.00 	217033858	 1.00 	2022
760	Central Intelligence	216972543	127440871	 0.59 	89531672	 0.41 	2016
761	Million Dollar Baby	216763646	100492203	 0.46 	116271443	 0.54 	2004
762	The Help	216639112	169708112	 0.78 	46931000	 0.22 	2011
763	Twins	216614388	111938388	 0.52 	104676000	 0.48 	1988
764	Little Women	216601214	108101214	 0.50 	108500000	 0.50 	2019
765	Valentine's Day	216485654	110485654	 0.51 	106000000	 0.49 	2010
766	Bad Teacher	216197492	100292856	 0.46 	115904636	 0.54 	2011
767	A Little Red Flower	216000000	0	0.00	216000000	 1.00 	2020
768	The Croods 2: A New Age	215905815	58568815	 0.27 	157337000	 0.73 	2020
769	Clear and Present Danger	215887717	122187717	 0.57 	93700000	 0.43 	1994
770	One Hundred and One Dalmatians	215880014	144880014	 0.67 	71000000	 0.33 	1961
771	Ted 2	215863606	81476385	 0.38 	134387221	 0.62 	2015
772	Bram Stoker's Dracula	215862692	82522790	 0.38 	133339902	 0.62 	1992
773	Vertical Limit	215663859	69243859	 0.32 	146420000	 0.68 	2000
774	Ghostbusters II	215394738	112494738	 0.52 	102900000	 0.48 	1989
775	The Patriot	215294342	113330342	 0.53 	101964000	 0.47 	2000
776	The Sorcerer's Apprentice	215283742	63150991	 0.29 	152132751	 0.71 	2010
777	Just Go with It	214945591	103028109	 0.48 	111917482	 0.52 	2011
778	The Expendables 3	214657577	39322544	 0.18 	175335033	 0.82 	2014
779	Dirty Dancing	214577242	64577242	 0.30 	150000000	 0.70 	1987
780	Creed II	214215889	115715889	 0.54 	98500000	 0.46 	2018
781	Public Enemies	214104620	97104620	 0.45 	117000000	 0.55 	2009
782	Smallfoot	214040103	83240103	 0.39 	130800000	 0.61 	2018
783	The Bourne Identity	214034224	121661683	 0.57 	92372541	 0.43 	2002
784	Disclosure	214015089	83015089	 0.39 	131000000	 0.61 	1994
785	Pulp Fiction	213928762	107928762	 0.50 	106000000	 0.50 	1994
786	The Aviator	213719942	102610330	 0.48 	111109612	 0.52 	2004
787	Crouching Tiger Hidden Dragon	213525736	128078872	 0.60 	85446864	 0.40 	2000
788	Braveheart	213216216	75609945	 0.35 	137606271	 0.65 	1995
789	Into the Woods	212902372	128002372	 0.60 	84900000	 0.40 	2014
790	Bedtime Stories	212874864	110101975	 0.52 	102772889	 0.48 	2008
791	Miss Congeniality	212742720	106807667	 0.50 	105935053	 0.50 	2000
792	Entrapment	212404396	87704396	 0.41 	124700000	 0.59 	1999
793	Ace Ventura: When Nature Calls	212385533	108385533	 0.51 	104000000	 0.49 	1995
794	End of Days	211989043	66889043	 0.32 	145100000	 0.68 	1999
795	Bridget Jones's Baby	211952420	24252420	 0.11 	187700000	 0.89 	2016
796	Fury	211822697	85817906	 0.41 	126004791	 0.59 	2014
797	Battle Los Angeles	211819354	83552429	 0.39 	128266925	 0.61 	2011
798	Australia	211787511	49554002	 0.23 	162233509	 0.77 	2008
799	Due Date	211780824	100539043	 0.47 	111241781	 0.53 	2010
800	Master and Commander: The Far Side of the World	211622535	93927920	 0.44 	117694615	 0.56 	2003
801	A Series of Unfortunate Events	211468235	118634549	 0.56 	92833686	 0.44 	2004
802	The Little Mermaid	211343479	111543479	 0.53 	99800000	 0.47 	1989
803	District 9	210888950	115646235	 0.55 	95242715	 0.45 	2009
804	Moonraker	210308099	70308099	 0.33 	140000000	 0.67 	1979
805	The Others	209947037	96522687	 0.46 	113424350	 0.54 	2001
806	Horrible Bosses	209838559	117538559	 0.56 	92300000	 0.44 	2011
807	Us and Them	209221380	0	0.00	209221380	 1.00 	2018
808	Red Dragon	209196298	93149898	 0.45 	116046400	 0.55 	2002
809	Tomorrowland	209035668	93436322	 0.45 	115599346	 0.55 	2015
810	Me Before You	208314186	56245075	 0.27 	152069111	 0.73 	2016
811	Safe House	208076205	126373434	 0.61 	81702771	 0.39 	2012
812	SWAT	207725639	116934650	 0.56 	90790989	 0.44 	2003
813	Traffic	207515725	124115725	 0.60 	83400000	 0.40 	2000
814	The Fast and the Furious	207305509	144533925	 0.70 	62771584	 0.30 	2001
815	Paranormal Activity 3	207039844	104028807	 0.50 	103011037	 0.50 	2011
816	Philadelphia	206678440	77446440	 0.37 	129232000	 0.63 	1993
817	Sleepy Hollow	206071502	101071502	 0.49 	105000000	 0.51 	1999
818	The Holiday	205850134	63224849	 0.31 	142625285	 0.69 	2006
819	Raging Fire	205846481	385305	 0.00 	205461176	 1.00 	2021
820	The Jungle Book	205843612	141843612	 0.69 	64000000	 0.31 	1967
821	London Has Fallen	205754447	62524260	 0.30 	143230187	 0.70 	2016
822	The Break0Up	205668210	118703275	 0.58 	86964935	 0.42 	2006
823	Journey to the West	205637183	18058	 0.00 	205619125	 1.00 	2013
824	JFK	205405498	70405498	 0.34 	135000000	 0.66 	1991
825	White House Down	205366737	73103784	 0.36 	132262953	 0.64 	2013
826	A Dog's Purpose	205035819	64508620	 0.31 	140527199	 0.69 	2017
827	Ponyo	204826668	15743471	 0.08 	189083197	 0.92 	2008
828	Fun with Dick and Jane	204681899	110332737	 0.54 	94349162	 0.46 	2005
829	Eat Pray Love	204594016	80574010	 0.39 	124020006	 0.61 	2010
830	You Don't Mess with the Zohan	204313400	100018837	 0.49 	104294563	 0.51 	2008
831	The Addams Family	203783845	100723831	 0.49 	103060014	 0.51 	2019
832	King Arthur	203567857	51882244	 0.25 	151685613	 0.75 	2004
833	Hairspray	203553311	118871849	 0.58 	84681462	 0.42 	2007
834	Yogi Bear	203509374	100246011	 0.49 	103263363	 0.51 	2010
835	Everest	203427584	43482270	 0.21 	159945314	 0.79 	2015
836	Vanilla Sky	203388341	100618344	 0.49 	102769997	 0.51 	2001
837	Arrival	203388186	100546139	 0.49 	102842047	 0.51 	2016
838	Need for Speed	203277636	43577636	 0.21 	159700000	 0.79 	2014
839	Garfield	203172417	75369589	 0.37 	127802828	 0.63 	2004
840	Patch Adams	202292902	135026902	 0.67 	67266000	 0.33 	1998
841	The Conjuring: The Devil Made Me Do It	202031050	65631050	 0.32 	136400000	 0.68 	2021
842	Teenage Mutant Ninja Turtles	201965915	135265915	 0.67 	66700000	 0.33 	1990
843	Kindergarten Cop	201957688	91457688	 0.45 	110500000	 0.55 	1990
844	Birds of Prey	201858461	84158461	 0.42 	117700000	 0.58 	2020
845	Straight Outta Compton	201634991	161197785	 0.80 	40437206	 0.20 	2015
846	21 Jump Street	201585328	138447667	 0.69 	63137661	 0.31 	2012
847	Valkyrie	201545517	83077833	 0.41 	118467684	 0.59 	2008
848	Open Season	200811689	85105259	 0.42 	115706430	 0.58 	2006
849	Cats & Dogs	200687492	93385515	 0.47 	107301977	 0.53 	2001
850	The Hunt for Red October	200512643	122012643	 0.61 	78500000	 0.39 	1990
851	Percy Jackson: Sea of Monsters	199850315	68559554	 0.34 	131290761	 0.66 	2013
852	Two Weeks Notice	199043471	93354851	 0.47 	105688620	 0.53 	2002
853	RED	199006387	90380162	 0.45 	108626225	 0.55 	2010
854	Shock Wave 2	198921659	0	0.00	198921659	 1.00 	2020
855	City of Angels	198685114	78685114	 0.40 	120000000	 0.60 	1998
856	The Pacifier	198636868	113086868	 0.57 	85550000	 0.43 	2005
857	50 First Dates	198520934	120908074	 0.61 	77612860	 0.39 	2004
858	Total Recall	198467168	58877969	 0.30 	139589199	 0.70 	2012
859	The Island	198326350	670883	 0.00 	197655467	 1.00 	2018
860	The Impossible	198087212	19019882	 0.10 	179067330	 0.90 	2012
861	Lost in Thailand	197757387	57387	 0.00 	197700000	 1.00 	2012
862	Christopher Robin	197744377	99215042	 0.50 	98529335	 0.50 	2018
863	Jack the Giant Slayer	197687603	65187603	 0.33 	132500000	 0.67 	2013
864	Smurfs: The Lost Village	197183546	45020282	 0.23 	152163264	 0.77 	2017
865	Chinese Doctors	197143218	0	0.00	197143218	 1.00 	2021
866	Ghostbusters: Afterlife	197126645	129126645	 0.66 	68000000	 0.34 	2021
867	Spy Kids 3: Game Over	197101678	111761982	 0.57 	85339696	 0.43 	2003
868	Panic Room	197079546	96397334	 0.49 	100682212	 0.51 	2002
869	The Other Woman	196710396	83911193	 0.43 	112799203	 0.57 	2014
870	Stargate	196567262	71567262	 0.36 	125000000	 0.64 	1994
871	Beowulf	196393745	82280579	 0.42 	114113166	 0.58 	2007
872	The Vow	196114570	125014030	 0.64 	71100540	 0.36 	2012
873	Anger Management	195745823	135645823	 0.69 	60100000	 0.31 	2003
874	Tropic Thunder	195702963	110515313	 0.56 	85187650	 0.44 	2008
875	The Shape of Water	195333312	63859435	 0.33 	131473877	 0.67 	2017
876	Rocketman	195320400	96368160	 0.49 	98952240	 0.51 	2019
877	The Pelican Brief	195268056	100768056	 0.52 	94500000	 0.48 	1993
878	The BFG	195243411	55483770	 0.28 	139759641	 0.72 	2016
879	The Intern	194564672	75764672	 0.39 	118800000	 0.61 	2015
880	Wallace & Gromit: The Curse of the Were0Rabbit	194137091	56110897	 0.29 	138026194	 0.71 	2005
881	Gnomeo & Juliet	193967670	99967670	 0.52 	94000000	 0.48 	2011
882	Weathering with You	193932489	8056636	 0.04 	185875853	 0.96 	2019
883	The Sum of All Fears	193921372	118907036	 0.61 	75014336	 0.39 	2002
884	Gangs of New York	193772504	77812000	 0.40 	115960504	 0.60 	2002
885	The Monkey King 2	193678298	709982	 0.00 	192968316	 1.00 	2016
886	Paranormal Activity	193355800	107918810	 0.56 	85436990	 0.44 	2009
887	The Equalizer	192330738	101530738	 0.53 	90800000	 0.47 	2014
888	The Lego Movie 2: The Second Part	192306508	105806508	 0.55 	86500000	 0.45 	2019
889	Sheep Without a Shepherd	191602146	0	0.00	191602146	 1.00 	2019
890	The Addams Family	191502426	113502426	 0.59 	78000000	 0.41 	1991
891	The Longest Yard	191466556	158119460	 0.83 	33347096	 0.17 	2005
892	The Santa Clause	190539357	145539357	 0.76 	45000000	 0.24 	1994
893	Cheaper by the Dozen	190538630	138614544	 0.73 	51924086	 0.27 	2003
894	The Equalizer 2	190400157	102084362	 0.54 	88315795	 0.46 	2018
895	Hollow Man	190213455	73209340	 0.38 	117004115	 0.62 	2000
896	Outbreak	189859560	67659560	 0.36 	122200000	 0.64 	1995
897	The White Storm 2: Drug Lords	189396380	609461	 0.00 	188786919	 1.00 	2019
898	The X Files	189176423	83898313	 0.44 	105278110	 0.56 	1998
899	Breakup Buddies	189017596	777896	 0.00 	188239700	 1.00 	2014
900	Rambo III	189015611	53715611	 0.28 	135300000	 0.72 	1988
901	The Secret Life of Walter Mitty	188133322	58236838	 0.31 	129896484	 0.69 	2013
902	Project Gutenberg	188116796	0	0.00	188116796	 1.00 	2018
903	Jaws 2	187884007	81766007	 0.44 	106118000	 0.56 	1978
904	12 Years a Slave	187733202	56671993	 0.30 	131061209	 0.70 	2013
905	Heat	187436818	67436818	 0.36 	120000000	 0.64 	1995
906	Mr Popper's Penguins	187361754	68224452	 0.36 	119137302	 0.64 	2011
907	The Grudge	187281115	110359362	 0.59 	76921753	 0.41 	2004
908	I Now Pronounce You Chuck & Larry	187134117	120059556	 0.64 	67074561	 0.36 	2007
909	The Horse Whisperer	186883563	75383563	 0.40 	111500000	 0.60 	1998
910	Walk the Line	186797986	119519402	 0.64 	67278584	 0.36 	2005
911	Jian Bing Man	186699768	0	0.00	186699768	 1.00 	2015
912	The Jungle Book 2	186303759	47901582	 0.26 	138402177	 0.74 	2003
913	The Final Destination	186167139	66477700	 0.36 	119689439	 0.64 	2009
914	Atlantis: The Lost Empire	186053725	84056472	 0.45 	101997253	 0.55 	2001
915	Inside Man	186003591	88513495	 0.48 	97490096	 0.52 	2006
916	The Waterboy	185991646	161491646	 0.87 	24500000	 0.13 	1998
917	Hugo	185770310	73864507	 0.40 	111905803	 0.60 	2011
918	Pitch Perfect 3	185400345	104897530	 0.57 	80502815	 0.43 	2017
919	Watchmen	185382813	107509799	 0.58 	77873014	 0.42 	2009
920	The Birdcage	185260553	124060553	 0.67 	61200000	 0.33 	1996
921	Moulin Rouge!	184935320	57386607	 0.31 	127548713	 0.69 	2001
922	Snow White and the Seven Dwarfs	184925486	184925486	 1.00 	0	0.00	1937
923	Hop	183954145	108085305	 0.59 	75868840	 0.41 	2011
924	Bad Moms	183936074	113257297	 0.62 	70678777	 0.38 	2016
925	Jupiter Ascending	183887723	47387723	 0.26 	136500000	 0.74 	2015
926	Knowing	183658498	79957634	 0.44 	103700864	 0.56 	2007
927	102 Dalmatians	183611771	66957026	 0.36 	116654745	 0.64 	2000
928	Stand by Me Doraemon	183442714	0	0.00	183442714	 1.00 	2014
929	Storks	183388953	72679278	 0.40 	110709675	 0.60 	2016
930	Paul Blart: Mall Cop	183348429	146336178	 0.80 	37012251	 0.20 	2009
931	Wayne's World	183097323	121697323	 0.66 	61400000	 0.34 	1992
932	Maverick	183031272	101631272	 0.56 	81400000	 0.44 	1994
933	Mirror Mirror	183018522	64935167	 0.35 	118083355	 0.65 	2012
934	The Man in the Iron Mask	182968902	56968902	 0.31 	126000000	 0.69 	1998
935	Cape Fear	182291969	79091969	 0.43 	103200000	 0.57 	1991
936	The Haunted Mansion	182290266	75847266	 0.42 	106443000	 0.58 	2003
937	The Monkey King Havoc in Heavens Palace	182206924	0	0.00	182206924	 1.00 	2014
938	While You Were Sleeping	182057016	81057016	 0.45 	101000000	 0.55 	1995
939	The Bridges of Madison County	182016617	71516617	 0.39 	110500000	 0.61 	1995
940	From Vegas to Macau III	181732879	0	0.00	181732879	 1.00 	2016
941	Poseidon	181674817	60674817	 0.33 	121000000	 0.67 	2006
942	The First Wives Club	181489203	105489203	 0.58 	76000000	 0.42 	1996
943	Cliff Walkers	181325565	152972	 0.00 	181172593	 1.00 	2021
944	Scooby0Doo 2: Monsters Unleashed	181216833	84216833	 0.46 	97000000	 0.54 	2004
945	Hot Shots!	181096164	69467617	 0.38 	111628547	 0.62 	1991
946	Road to Perdition	181001478	104454762	 0.58 	76546716	 0.42 	2002
947	Kill Bill: Vol 1	180906076	70099045	 0.39 	110807031	 0.61 	2003
948	The Scorpion King	180630907	91047077	 0.50 	89583830	 0.50 	2002
949	Sweet Home Alabama	180622424	127223418	 0.70 	53399006	 0.30 	2002
950	Daddy's Home 2	180613824	104029443	 0.58 	76584381	 0.42 	2017
951	Hacksaw Ridge	180563636	67209615	 0.37 	113354021	 0.63 	2016
952	Deja Vu	180557550	64038616	 0.35 	116518934	 0.65 	2006
953	The Post	180419276	81903458	 0.45 	98515818	 0.55 	2017
954	Abominable	180289970	60826390	 0.34 	119463580	 0.66 	2019
955	Dangerous Minds	179519401	84919401	 0.47 	94600000	 0.53 	1995
956	The Dictator	179379533	59650222	 0.33 	119729311	 0.67 	2012
957	The League of Extraordinary Gentlemen	179265204	66465204	 0.37 	112800000	 0.63 	2003
958	Allegiant	179246868	66184051	 0.37 	113062817	 0.63 	2016
959	Daredevil	179179718	102543518	 0.57 	76636200	 0.43 	2003
960	City Slickers	179033791	124033791	 0.69 	55000000	 0.31 	1991
961	He's Just Not That Into You	178866158	93953653	 0.53 	84912505	 0.47 	2009
962	Eagle Eye	178767383	101440743	 0.57 	77326640	 0.43 	2008
963	Along Came Polly	178311729	88097164	 0.49 	90214565	 0.51 	2004
964	Flushed Away	178281554	64665672	 0.36 	113615882	 0.64 	2006
965	Scary Movie 4	178262620	90710620	 0.51 	87552000	 0.49 	2006
966	Dante's Peak	178127760	67127760	 0.38 	111000000	 0.62 	1997
967	Brokeback Mountain	178062759	83043761	 0.47 	95018998	 0.53 	2005
968	Patriot Games	178051587	83351587	 0.47 	94700000	 0.53 	1992
969	Flubber	177977226	92977226	 0.52 	85000000	 0.48 	1997
970	Baywatch	177856751	58060186	 0.33 	119796565	 0.67 	2017
971	Double Jeopardy	177841558	116741558	 0.66 	61100000	 0.34 	1999
972	War Horse	177584879	79884879	 0.45 	97700000	 0.55 	2011
973	Paranormal Activity 2	177512032	84752907	 0.48 	92759125	 0.52 	2010
974	How to Lose a Guy in 10 Days	177502387	105813373	 0.60 	71689014	 0.40 	2003
975	Alien vs Predator	177427090	80282231	 0.45 	97144859	 0.55 	2004
976	Hero	177395557	53710019	 0.30 	123685538	 0.70 	2002
977	The 400Year0Old Virgin	177378645	109449237	 0.62 	67929408	 0.38 	2005
978	Lee Daniels' The Butler	177313795	116632095	 0.66 	60681700	 0.34 	2013
979	The Haunting	177311151	91411151	 0.52 	85900000	 0.48 	1999
980	The Descendants	177243185	82584160	 0.47 	94659025	 0.53 	2011
981	The A0Team	177238796	77222099	 0.44 	100016697	 0.56 	2010
982	Tootsie	177200000	177200000	 1.00 	0	0.00	1982
983	In the Line of Fire	176997168	102314823	 0.58 	74682345	 0.42 	1993
984	Analyze This	176885658	106885658	 0.60 	70000000	 0.40 	1999
985	The Hitman's Bodyguard	176600207	75468583	 0.43 	101131624	 0.57 	2017
986	Looper	176506819	66486205	 0.38 	110020614	 0.62 	2012
987	Serial (Bad) Weddings	176404493	0	0.00	176404493	 1.00 	2014
988	Ip Man 4: The Finale	176345966	3956031	 0.02 	172389935	 0.98 	2019
989	Dr Dolittle 2	176104344	112952899	 0.64 	63151445	 0.36 	2001
990	The Italian Job	176070171	106128601	 0.60 	69941570	 0.40 	2003
991	The Bucket List	175372502	93466502	 0.53 	81906000	 0.47 	2007
992	Sleeping with the Enemy	174999005	101599005	 0.58 	73400000	 0.42 	1991
993	Cowboys & Aliens	174822325	100240551	 0.57 	74581774	 0.43 	2011
994	The Mule	174804407	103804407	 0.59 	71000000	 0.41 	2018
995	George of the Jungle	174463257	105263257	 0.60 	69200000	 0.40 	1997
996	Evan Almighty	174440724	100462298	 0.58 	73978426	 0.42 	2007
997	Amélie	174118254	33225499	 0.19 	140892755	 0.81 	2001
998	Identity Thief	173965010	134506920	 0.77 	39458090	 0.23 	2013
999	The Nutcracker and the Four Realms	173961069	54858851	 0.32 	119102218	 0.68 	2018
1000	Big Momma's House	173959438	117559438	 0.68 	56400000	 0.32 	2000
